10  10
0 0 0 0 0 0 0 1 0 0
0 0 3 2 5 3 2 5 6 4
0 1 1 7 6 1 1 7 9 0
1 1 4 0 1 9 4 8 6 0
1 1 4 1 9 9 1 8 3 4
0 3 1 1 2 1 1 2 1 0
0 1 0 0 1 0 4 0 0 0
1 2 0 1 0 0 5 0 7 8
0 0 0 2 3 0 6 1 3 0
1 0 3 9 4 0 1 0 2 0